1111111111111
10010EC000111
1000011111111
1P00110000111
1111111111111