1111111111111111111111111111
1000100000000000000000000001
1111111000000000000000000001
1P0CE10000000M00000000000001
1101100000000000000000000001
1010000000000000000000000001
1111111111111111111111111111