1111111111111111111111
1000000100000011000001
1000100100000000000E01
10P0100100111C00001111
10001000C00000000000C1
1111111111111111111111