1111111111111111111111
1010111100000000000001
10000111000P0000000E01
100C01110000C000000001
1010111000000000000000
1111111111111111111111