1111111111111111111111
1010111100000000000001
1000111100000000000001
1000111000000000000001
10100000000000000CEP01
1111111111111111111111