1111111111111111111111111111111111111
1P10111100000C00000000000000000000001
1010000000000000000000000000000000001
1000111111000000000000000000000000001
1000111111000000000000000000000000001
10100000000000000000000000000000000E1
1111111111111111111111111111111111111