1111111111111111111111
1010111100000000000001
1000111100000E00000001
1000111000000000P00001
10100000000C0000000001
1111111111111111111111