1111111111111111111111
1000100000000000000001
1000100000000000000E01
100010000000C00C000001
10001000000P0000000001
1111111111111111111111